#####################################################################################################
A #             #           #       #   #               #             # #                 #         #
# # ####### ### # ######### # # ### # # # ##### ##### # ########### # # # ######### ### # ### ##### #
# #     #   # #   # #     # # #   # # # # #   # #     #             # #   #       # #   #     #   # #
# ####### ### ##### # ### # # ### # # # # # # ### ################### ### # ##### ### ######### # # #
#     #   #   #   #   # #   #   # #   # # # #     #   #             #   # # #   #   # #         # # #
##### # ### ### # # ### ######### ##### ### ####### # # ######### ##### ### # # ### # # ######### # #
#   #   #   #   # #   #           #   #     #     # #   # #     # #   # #   # # #   # #     #   # # #
# # ##### # # ### ### ####### ##### ######### ### # ##### # ### # # # # # ### ### ### ### ### # # # #
# #   #   #   # #   #         # #         # # #   #   #     #   #   # #   #     #   #     #   #   # #
### ### ####### ### ########### # ##### # # # # ##### ####### # ##### ######### ### ### ### ####### #
#   #   #         #     #       #   # # #   # #     #     #   #   #   #         # #   #   # #     # #
# ### ####### ####### # # # ####### # # # ### ##### ##### # ### ### # # # ##### # ### ### # # ##### #
#   # #     #   #     # # #   #   # # # # #   #   #     #   # # #   # # # #   #     #   # # #   #   #
# # # # ### ### # ##### # ### # # # # # ### ### ##### # ##### # # ### # # # # ##### ### ### ### # ###
# # #   #   #   #   # # #   #   #   # #     # #     # #   #     # #   # #   # #   # #   #   #   # # #
### ##### ### # ### # # ### ######### ####### # ### # ### # ##### ##### ##### # # ### ### ### ### # #
#   #   #     #   # #   #   #             #       # #   # #   #   #   # #   #   #   #     # #     # #
# ### # ######### # ##### ### ########### # ####### ### # ### # ### # # # # ####### ####### # ##### #
# #   #   #     # #     # #       #       # #     #   # #   # #     #   # # #     #       #   #     #
# # ### ### # # # ##### # ######### ####### # ### # ### ### # ########### # ##### ##### # # ####### #
# #   # #   # # # #   #   #       #   #   # # # # #   #   # # #           #       #     # #         #
# ### # # ### ### ### ##### ##### ### # # # # # # ### ### ### ### ####### ######### ##### ######### #
#   # #   #   #   #         #   #   #   #   # #     #   #   #     #   #   #         # #   #     #   #
### # ##### ### ### ######### # ### # ####### ##### ### ### ##### # # ##### ######### # ##### # # ###
#   #   # #   #     #     #   #     #     # #     # #   #   #     # #     #   #       #   #   # #   #
# ##### # ### ####### ### # ############# # ##### # # ### ### ##### ##### ### ### # ##### # ####### #
#   #   #   #     #   #   #     #       #     #   # # #   #     #   #   #   # #   # #       #       #
### # ### # ### ### ### ####### # ##### # ##### ### # # ### ##### ### # ### # # ### # ####### #######
#   # #   # #   #   # #         # #   # # #     #   # #     #     #   #   #   # #   #   #   #       #
# ### # ### # # # ### ########### ### # ### ##### ### ####### ##### ##### ##### # ##### # # ####### #
#   # # #   # # #               #   # #     #   #         #   #     # #   #     # #   # # #       # #
### # ### # # ##### ##### ##### ### # ####### # ####### ### ### ##### # ### ### ### # # # ##### ### #
#   #     # #     # #   # #   #     #   #     #   # #   #   #         # #   # #   # # # #   #   #   #
# ### ########### # # # ### # ####### # # ### ### # # ### ##### ####### # ### ### # # # ### # ### ###
#   # #         #   # #     #     #   # # # #   #   #   # #   # #     #   #     #   # #   # # #   # #
# # # # ####### ### # ########### ##### # # ### # ### ### # # ### ### ### # ### ##### # ### # # ### #
# # # # #     #   # #   #       #     # # #   # # #   #   # #       #   # # #   #   #   #   # #   # #
### # # ### ##### # ### # # ######### # # # ### ### ### # # ########### # ### # # # ##### ### ### # #
#   # # #   #     #   # # # #         # # #   #     #   # #   #       # #     #   #   #     #   #   #
# ### # # # # ######### # ### ######### # ### ####### ### ### # ##### # ########### ### ####### ### #
#   # # # # #   #       #   #   #     #       #     # #     # #   #   # #       #   #   # #       # #
# # # # # ##### # ######### ### ### # ####### # ### # # ##### ### # ### # ##### ##### ### # ####### #
# # # # # #   # # #           #     #   #     #   # # #   #   #   # #   #     #     #   # #     #   #
# # # # # # # # # # # ################# # ######### # ##### ### ### ### ##### ##### ### # ##### # ###
# #   # #   # #   # # #     #   #       # #         #       #   #           # #     #   #     #   # #
# ##### # ### ##### # # ### # # # ####### ### ##### ######### ########### ### # ##### ####### ##### #
# #   # #   #     # # #   #   # # #     #     #   #   #       #     # #   #   # #     #       #     #
### # # ### # ##### # ### ##### # # ### ######### # ### ####### ### # # ### ### # ##### ##### # ### #
#   #   # # #       # #   #     #   # #     #     # #   #   #     # #   #   #   #   #   #   #   #   #
# ####### # ######### # ### ######### ##### # ##### # ### # # ##### ##### ### # ### # ##### ##### ###
# #         #       # #   # #       #       #       # #   #   #     #   # #   #   # #     #     #   #
# ####### ##### # ### ### # # # ##### ########### ### # ####### # ### # # # ##### # ##### ##### ### #
# #     # #     # #     # #   #   #   #         # #   #   # #   # #   # # #     # # #     #     # # #
# # ### # # ##### # ##### ####### # ######### # ### ##### # # ##### ### # ##### ### # ##### ### # # #
#   #   # # # #   #     # #     #             # #   #     # #     # #   #   # #     # #       #   # #
# ### ### # # # ####### # # ### # ############# # # # ##### ##### # # ##### # ####### # ##### ### # #
# #   #     # #   #   #   # # # # #     #     #   # #   #   #   #   #       #         # #     # # # #
# # ######### ### # # ### # # # # # ### # ### ##### ### # ### # ################### ##### ##### # # #
# #       #   #   # #   # # # # # #   # # #     #   #   #   # #     #     #     #   #   #   # #   # #
# ####### # # # ### ### # # # # # ### # ### ##### ### ##### # ##### # # # ### # # ### # ### # # ### #
# #     # # #   #   # # # #   # #   # #   #   #   #   #   # #     #   # #   # #   #   #     #     # #
# # ### # # ##### ### # ##### # ### # ### ### # ### ### # # ##### ##### ### # ##### ### ########### #
#   #   # # #     #   #     # #   # # # #   # # #   #   # # #   # #   #   #   #       # #           #
##### ### # # ####### ### ### ### ### # ### # # # ### ### # # # # # ##### ##### ##### # # ###########
#   #   # # # #         #   #   #     # #   #   #     #   #   # #   #   #   #   #     # #     #     #
# # ### # # # ### ##### ### ### ####### # ### ######### ### ### ### # # ### # ### ##### ##### # # ###
# #     # # #   #   #   # #   # #     # #   #   #     #   # #     # # #     #   # #       #   # #   #
# ##### # ##### ### # ### # ### # # # # ### ##### # ##### ### ##### # ########### ######### ### ### #
# #   # #     #     # #   # #   # # #     #       #     #   #   #   # #         #   #   #   #   # # #
# # # ####### ####### # # # # ### # ################### ### ### # ### ### ##### ### # # # ### ### # #
# # #       #       #   # #   #   #               #       #   #     # #   #   #     # #   # #     # #
### ####### ### ### ##### ################# # ##### ### ##### # ##### # ### ####### # ##### ##### # #
#   #     #   # # #     # #     #     #   # #   #   # # #     # #     # #   #   #   # # #   #     # #
# ##### ##### # # ##### # ### # # ### # # ##### # ### # # ####### ##### ### # # # ### # # # # ##### #
#     #     #   #     # #     #   # #   #       # #     #         #     #   # #   #   # # # #   #   #
##### ##### ##### ### # ########### ########### # ################# ### # ### ##### ### # # # ### # #
#   # #         # # #   #     #   #   #     #   #   #       #         # # #   #   #   #   #   #   # #
# # # # ######### # ##### ### ### # # # ### # ##### # ### # # ######### # # ### ##### # ####### ### #
# #   #       #   #     # # # #   # #   # # #     #     # # # # #       #   #   #     # #   #   #   #
# ####### ### # ##### # # # # # # # ##### # ##### ####### # # # # ####### ##### # ##### # # # ### ###
# #     #   # #       # # #   # # #   #   # #   #     #   # #   #     #   #     # #   # # # # #   # #
# # ### ### # ######### # # ### ##### # # # # # ##### # ### ### ##### # ### ##### # # # # # # # ### #
#   #   #   #   # #   #   #     #     # # #   #   #   # # #   # # #   #     #   #   # #   # # # #   #
# ### ### ### # # # # # ######### ##### # ####### # ### # ### # # # ####### # # ##### ### ### # ### #
#   # #   # # #   # #   #   #   #   #   # #     # #   # #     #   #     #   # #   #   # # #   # #   #
##### # ### # ##### ##### # # # ### # ### # ##### ### # ######### ##### ### # ### # ### # # ### # # #
#     #     #   #   #   # #   #     # # #   #     # # #   #       #   #   # # # #   #   # # #     # #
# ############# # ### # # ########### # # ### ### # # ### # ####### ##### # # # ##### # # # ####### #
#   #   #     #   #   #   #           #   #   #   # #   #   #           # # #     #   #   # #   #   #
# # # # # ### ##### ####### ########### ### ### ### ### ####### ##### # # ####### ### ##### # # #####
# #   #   # #       #       #         # #   # #     # #       # #   # # #       #   #   #   # #     #
# ######### ########### ### # ####### # # ### ##### # ####### ### # # # ####### ### ### # ### ##### #
# #     #             # #   # #       # # #           #     #     # # #   #     # # # # #       #   #
# ### # # ######### # # # ### # ######### # ########### # ######### ### # # ### # # # # ######### # #
#     # #     #     #   # #   #     #     # #       #   #   #   #   #   # #   #   # # # #     #   # #
####### ### ### ######### # ####### # ### ### ##### # ##### # # # ### ####### ##### # # # ##### ### #
#   #   #   #   #     #   #     #     #   #   # #   #     #   # #   #     #   #     #     #   # # # #
# ### ####### ### ##### ####### ########### ### # ####### ##### ### ##### # ### ########### # # # # #
#             #               #                 #             #           #                 #   #   B
#####################################################################################################